############
#S.....#...#
#.###.#.#.#E
#.#...#.#.##
#.#.###.#..#
#.#.....##.#
#.#####....#
#.......####
############