############
#S.E...#...#
#.###.#.#..#
#.#...#.#.##
#.#.###.#..#
#.#.....##.#
#.#####....#
#.......####
############