###############
#S......#.....#
#.#####.#.###.#
#.....#.#...#.#
###.#.#.###.#.#
#...#.#.....#.#
#.###.#######.#
#.#...........#
#.#.#########.#
#.#.........#.#
#.#########.#.#
#...........#E#
###############