########################################
#S.................#...............#####
#.########.#######.#.#############.#####
#.######.#.#######.#.#############.#####
#.######.#.#######.#.#########.......###
#.######.#...........#########.###.#.###
#.######.#.#######.#.#########.###.#.###
#.######.#.#######.#.#########.###.#.###
#.######.#.###.....#.#####.........#.###
#.######.#.###.#####.#####.###.#####.###
#........#.###.#####.#####.###.#####...#
##########.###.#####.#####.###.#######.#
####...........................#######.#
####.#####.###.###########.###.#######.#
####.#####.......#########.###.#######.#
####.###########.#########.###.#########
####.###########.#######.....#.#########
####.###########.#######.#####.#########
####...........#.#######.#####.........#
##############.#.#######.#######.#####.#
############.....#######.#######.#####.#
############.#.#########.#######.#####.#
######.........#########.........#####E#
########################################