###############################
#S#     #     #       #       #
# # ### # ### ##### ### ### # #
# # #   #   #     #     # # # #
# ### ##### ##### ##### # # # #
#   #     # #   # #   # #   # #
### ##### # # # # # # # ##### #
#     #   #   #   # # #     # #
# ### # ########### # ##### # #
# #   #       #     #     # # #
# # ######### # ######### # # #
# # #       # #       #   #   #
# # # ##### # ##### ###  ######
# # # #   # #      #     #    #
# # # # # # #####  ####### ## #
#   #   # #     #        #    #
### ##### #####   ####### #####
#     #       # #       #     #
# ### ####### # #   ### ##### #
#   #       #   #     #     # #
# ##### ### #####   ##### # # #
#     #   #     #         #   #
##### ### ##### ###  ######## #
#     #   #     #     #       #
# ##### ### #####   ### # ### #
#     #     #     #     #   # #
##### ##### # #####   ##### # #
#         #   #       #     #E#
###############################