##########
#S.......#
#.####...#
#.#..#...#
#.#..#...#
#.#..###.#
#.#..##..#
#.####.#.#
#......E.#
##########