##########
#S#......#
#.#.####.#
#.#....#.#
#.####.#.#
#......#.#
#.######.#
#........#
#......E.#
##########