##########
#S.......#
#.######.#
#.#....#.#
#.#.##.#.#
#.#.##.#.#
#.#....#.#
#.######.#
#......E.#
##########